14
15
11111111111111
10000000000001
10000000000001
10000002000001
10000002000001
10022222222001
10020000002001
10022222222001
10020000002001
10022222222001
10000002000001
10000002000001
10000000000001
10000000000001
11111111111111
